9 8
XXXXXXXXX
XX   XXXX
X O O  XX
X X XX XX
X    BBPX
XXX X   X
XXX   XXX
XXXXXXXXX