10 10
XXXXXXXXXX
XO X X  OX
X    B   X
X XX XX XX
X  B B   X
X  XPX   X
X   B    X
X XX   XXX
XO  X   OX
XXXXXXXXXX

