9 9
XXXXXXXXX
X   O   X
X  B    X
X XXX X X
X   P   X
X X XXX X
X    B  X
X   O   X
XXXXXXXXX