10 10
XXXXXXXXXX
X O     OX
X  XXX   X
X B   B  X
X   X    X
X   P    X
X   X    X
X B   B  X
X O     OX
XXXXXXXXXX