10 10
XXXXXXXXXX
X O      X
X  XXX   X
X B  B   X
X    X   X
X P  B   X
X    X   X
X  O   O X
X        X
XXXXXXXXXX

