10 10
XXXXXXXXXX
X        X
X   P    X
X        X
X   B    X
X        X
X   O    X
X        X
X        X
XXXXXXXXXX

