10 10
XXXXXXXXXX
X  O   O X
X        X
X  B   B X
X        X
X   P    X
X        X
X   XX   X
X        X
XXXXXXXXXX